1111111111111
10010000001C1
1000011001111
1P0011E000001
1111111111111
