111111111111111
100000V0000C001
100C0000P0V0001
11V1110H0011111
1E00000C0011111
111111111111111
